XXXXXXXXXXXXXXXXXXXX
X                  X
X         a        X
X                  X
X        5         X
X                  X
X       3          X
X          g       X
X                  X
XXXXXXXXXXXXXXXXXXXX
3
5
2
