XXXXXXXXXXXXXXXXXXXXXXXXXXXXXX
X                        X   X
X                        X   X
X abcdefghi              X   X
X 12345678999999999      X   X
X          99999999      X   X
X          99999999          X
X          99999999          X
X          99999999  OOOOOO  X
X          99999999XXXXXXXXXXX
XXXXXXXXXXX                  X
X         O                  X
X             O              X
X                   O        X
XXXXXXXXXXXXXXXXXXXXXXXXXXXXXX
300
5,3,0,-1,3,-5
