XXXXXXXXXXXXXXXXXXXXXXXXXXXXXX
X                        X   X
X                        X   X
X          1             X   X
X                        X   X
X                        X   X
X                            X
X                            X
X                    OOOOOO  X
X                  XXXXXXXXXXX
XXXXXXXXXXX                  X
X         O                  X
X             O              X
X                   O        X
XXXXXXXXXXXXXXXXXXXXXXXXXXXXXX
100
0,1
