XXXXXXXXXXXXXXXXXXXXXXXXXXXXXX
X                            X
X                            X
X z                          X
X                            X
X                            X
X                            X
X                            X
X                            X
X        11111111            X
X        11111111            X
X        11111111            X
X                            X
X    P                       X
XXXXXXXXXXXXXXXXXXXXXXXXXXXXXX
300
-5,0
