XXXXXXXXXXXXXXXXXXXXXXXXXXXXXX
X                            X
X                            X
X                            X
X                            X
X                            X
X                            X
X                            X
X                            X
X        11111111            X
X        11111111            X
X        11111111            X
X                            X
X                            X
XXXXXXXXXXXXXXXXXXXXXXXXXXXXXX
300
-2,0
