XXXXXXXXXXXXXXXXXXXXXXXXXXXXXX
X                        X   X
X                        X   X
X a                      X   X
X                        X   X
X                        X   X
X                            X
X                            X
X                    OOOOOO  X
X                  XXXXXXXXXXX
XXXXXXXXXXX                  X
X         O                  X
X             O              X
X                   O        X
XXXXXXXXXXXXXXXXXXXXXXXXXXXXXX
3
5
