XXXXXXXXXXXXXXXXXXXXXXXXXXXXXX
XOOOOOOOOOOOOX               X
XOOOOOOOOOOOOX  P            X
XOOOOOOOOOOOOXOOOOOOOOOOOOOOOX
XOOOOOOOOOOOOX5e5e5e5e5e5e5e5X
XOOOOOOOOOOOOXe5e5e5e5e5e5e5eX
XOOOOOOOOOOOOX5e5e5e5e5e5e5e5X
XOOOOOOOOOOOOXe5e5e5e5e5e5e5eX
XOOOOOOOOOOOOX5e5e5e5e5e5e5e5X
XOOOOOOOOOOOOXe5e5e5e5e5e5e5eX
XOOOOOOOOOOOOXOOOOOOOOOOOOOOOX
XOOOOOOOOOOOOX          y    X
XOOOOOOOOOOOOX               X
XOOOOOOOOOOOOX               X
XXXXXXXXXXXXXXXXXXXXXXXXXXXXXX
1000
0
0
60
