XXXXXXXXXXXXXXXXXXXXXXXXXXXXXX
X                            X
X              y             X
X                            X
X                            X
X3333333333333333333333333333X
X                            X
X                            X
X                            X
X                            X
X                            X
X             P              X
X                            X
X                            X
XXXXXXXXXXXXXXXXXXXXXXXXXXXXXX
300
0
