XXXXXXXXXXXXXXXXXXXXXXXXXXXXXX
X            X               X
X            X  P            X
X            XOOOOOOOOOOOOOOOX
X            X5e5e5e5e5e5e5e5X
X            Xe5e5e5e5e5e5e5eX
X            X5e5e5e5e5e5e5e5X
X            Xe5e5e5e5e5e5e5eX
X            X5e5e5e5e5e5e5e5X
X            Xe5e5e5e5e5e5e5eX
X            XOOOOOOOOOOOOOOOX
X            X          y    X
X            X               X
X            X               X
XXXXXXXXXXXXXXXXXXXXXXXXXXXXXX
1000
0
0
60
