XXXXXXXXXXXXXXXXXXXXXXXXXXXXXX
X     OOOOOOOOOOOOOOOOOO     X
X     OOOOOOOOOOOOOOOOOO   z X
X   y OOOOOOOOOOOOOOOOOO     X
X     OOOOOOOOOOOOOOOOOO     X
XOOOOOOOOOOOOOOOOOOOOOOOOOOOOX
XOOOOOOOOOOO66666OOOOOOOOOOOOX
XOOOOOOOOOOO66666OOOOOOOOOOOOX
XOOOOOOOOOOO66666OOOOOOOOOOOOX
XOOOOOOOOOOXOOOOOXOOOOOOOOOOOX
X     OOOOOX     XOOOOOO     X
X   z OOOOOX  P  XOOOOOOy    X
X     OOOOOX     XOOOOOO     X
X     OOOOOX     XOOOOOO     X
XXXXXXXXXXXXXXXXXXXXXXXXXXXXXX
300
0
50
50
