XXXXXXXXXXXXXXXXXXXXXXXXXXXXXX
X              P             X
X   OXXXXXXXOOOOOXXXXXXXXO   X
X   Oe    6666hhhhh     5O   X
XOOOOe    6666hhhhh     5OOOOX
Xeeeee                  55555X
X                            X
X   z                    y   X
X        z  y     z y        X
XXXXX           y      yXXXXXX
XXXXX       y     z     XXXXXX
XXXXX    z XXXXXX z  y  XXXXXX
X   y      XXXXXX            X
X    z     XXXXXX         z  X
XXXXXXXXXXXXXXXXXXXXXXXXXXXXXX
300
0,-1,1
70
70
